0000000000000000
0110110110110110
0111111111111110
0010000000000100
0010000000000100
0010011001100100
0010011001100100
0010000000000100
0010000000000100
0010011000000100
0010011111100100
0010001111000100
0010000000000100
0011111111111100
0000000000000000
0000000000000000
