0000000011000000
0000001011000000
0000011111000000
0000110111000000
0001100011000000
0011000001100000
0011111111100000
0010000000100000
0010111110100000
0010101010100000
0010111110111100
0010101010100100
0010111110101100
0010000000100100
0011111111111100
0000000000000000
