1111111001111111
1010001001000101
1110011001100111
1000110000110001
1001100000011001
1011000000001101
1110000000000111
0000000000000000
0000000000000000
1110000000000111
1011000000001101
1001100000011001
1000110000110001
1110011001100111
1010001001000101
1111111001111111
